11111
1E101
101C1
10PC1
11111
