11111111111111111111111111
1010000001E010000000C00001
100001000P0000010000010011
11111111111111111111111111
